000000100100000
000000100000000
000000000000000
000000000000000
110000000010001
000000000010000
000000000010000
111111000000000
000000100000000
000000100000000
000000100000000
000001100000000
000000100011100
000000100000100
000000000000000
000000000000000
000000000000000
000000011000000
000000010000000
000000010000000