000000100100000
111000000000000
000000000000000
000000011000000
001000000000000
011000000000000
001000000000000
000000000000000
000000000000000
000000110001100
000000110000000
000000110000000
000000000000000
000000000000100
010000000000100
010010000000100
010100000000000
000000000000000
000000000000000
000000000111000