000000100100000
001000000000000
000000000000000
000000011000000
001000000000000
011000000000000
001000000000000
000000000000000
000000000000000
000000010001100
000000010000000
000000110000000
000000000000000
000000000000100
010000000000100
000010000000100
010100000000000
000000000000000
000000000000000
000000000111000