000000000000000
000000000000000
000000001000000
000000010000000
000000100000000
000001000000001
000000000000001
000000000000000
000000000000000
000000000001000
111000010001111
000000010000000
000000010000000
000000010000000
000100010000111
000100010000000
111100000000000
000000000000000
000000000000000
000000010000000