000000000100000
000000000100000
000000000100000
100000000100000
000000000010000
000000000100000
000111111000000
000000000000001
000000000000000
000000000000000
100000000110000
000000000100000
000000000100000
000000000011100
000000000100000
000000000100000
000100000100000
000010000000000
000001000000000
000000000000000