000001110000000
000010000000000
000100000000000
000000000000000
000011100000000
000000000000001
000000000000001
000000000000001
000010000000000
000111000000000
100010000100000
000000000110000
000000000100000
000000000000000
000000000000000
000100000000001
000100000000001
000110000000001
000000000000001
000000000100000