000000000000444
000000000000444
000000000000444
000000000000000
000000001111100
000000000000100
000000000000100
000000000000100
000000000000000
111111110000000
000000010000000
000000010000000
000000000000000
000000000000000
000000000000000
000000000001111
000000000000000
333000000000000
333000000000000
333000000000000