000000000100000
000000000000000
000000000000000
000001000000000
000010010011010
000100000000000
000100000000000
000000000000000
000000000000000
000000000001000
000100000001000
000001010101000
000000000001000
000000000001000
000000000001000
000111001000010
000000000000000
000000000000000
000000000000010
000001000000000