000000010000000
000000111000000
000000000000000
000000000000000
000100000000001
000100000100000
000000000100000
000000000000000
000111000001000
001000000001000
001000000000000
000000000000000
000000000000000
000000000000111
000111000000000
000010000000000
000000000000000
000000000011000
000000000011000
000000000011000