000000000000444
000000000000444
000000000000444
000000001000000
000000001111100
000000000000000
000000000000000
000000000000000
000000000000000
111111110000000
000000000000000
000000000000000
000000000000000
000000000000000
000000000000000
000000000000000
000000000000000
333000000000000
333000000000000
333000000000000