33300000000000000000
33300000111111111111
33300000100000000000
00000000100000000000
00000000100000000000
00000000000000000000
00000000000000000000
00000000000000000000
00000000000000000000
11111111000000000000
00000000000000000000
00000000000000000000
00000000000000000444
00000000000000000444
00000000000000000444